
LaunchBtn = Запустить!
UpdateBtn = Обновить
OK = OK
Yes = Да
No = Нет
Done = Готово
Proceed = Продолжить
Cancel = Отмена
Close = Закрыть
Minimize = Свернуть
Help = Помощь
About = О программе
Apply = Применить
Quit = Выйти
Retry = Повторить
RunOffline = Оффлайн-режим
Browse = Обзор...
ChangelogBtn = История изменений
LinksBtn = Полезные ссылки
StatusBtn = Состояние файлов
SettingsBtn = Настройки
ChangelogTooltip = Показать список изменений
StatusTooltip = Показать результаты проверки файлов
LinksTooltip = Показать полезные ссылки
SettingsTooltip = Открыть настройки лаунчера
Error = Ошибка
LoncherLoading = Запускаем {0}...
PressF1About = Нажмите F1, чтобы открыть информацию о программе
DLRate = Загружаем: {3} - {0} из {1} @ {2}
AllFilesIntact = Все файлы прошли проверку, можно взлетать.
FilesMissing = Файлов, не прошедших проверку: {0} (они отсутствуют либо устарели)
StatusListDownloadedFile = 
StatusListRecommendedFile = 
StatusListOptionalFile = 
StatusListRequiredFile = 
StatusListDownloadedFileTooltip = Файл на месте и готов к работе
StatusListRecommendedFileTooltip = Файл не прошёл проверку версии, но для корректной работы это не так важно. Однако, если у вас всё же возникнут проблемы с игрой, то будет резонно начать с того, чтобы скачать рекомендуемую нами версию файла.
StatusListOptionalFileTooltip = Необязательный файл
StatusListRequiredFileTooltip = Файл либо отсутствует, либо имеет неподходящую версию. Его необходимо скачать для корректной работы игры и русификатора.
StatusComboboxDownload = Загрузить
StatusComboboxDownloadForced = Будет загружен
StatusComboboxNoDownload = Не загружать
StatusComboboxUpdate = Обновить
StatusComboboxUpdateForced = Будет обновлён
StatusComboboxNoUpdate = Не обновлять
StatusCopyingFiles = Обновляем файлы в папке игры...
StatusUpdatingDone = Готово!
StatusDownloadError = Произошла ошибка при загрузке или копировании файлов
CannotDownloadFile = Не удаётся скачать файл "{0}"
CannotMoveFile = Невозможно переместить файл "{0}"
DirectoryAccessDenied = Невозможно переместить файл "{0}": отказано в доступе. Попробуйте перезапустить лаунчер от имени администратора.[n][n]Конкретная ошибка
UpdateSuccessful = Все файлы успешно обновлены![n]Запустить игру сейчас?
LauncherIsInOfflineMode = Новости недоступны: лаунчер работает в оффлайн-режиме
ModsBtn = Моды
ModsTooltip = Моды, доступные для данной версии игры
NoModsForThisVersion = Нет модов, доступных для вашей версии.
InstallMod = Установить
UninstallMod = Удалить
EnableMod = Включить
DisableMod = Отключить
FollowingModsAreDisabled = Следующие моды будут отключены, т.к. они не поддерживают текущую версию игры:[n]{0}
FollowingModsMayBeEnabled = Со следующими модами вы ранее играли на этой версии. Включить их?[n]{0}
CannotWriteCfg = Не удаётся записать данные в файл конфигурации
CannotReadCfg = Не удаётся прочитать данные из файла конфигурации
PreloaderTitle = Battle Brothers RU Löncher — Загрузка...
MainFormTitle = Battle Brothers RU Löncher
SettingsTitle = Настройки
SettingsGamePath = Путь к папке с игрой
SettingsGogGalaxy = Запускать игру через GOG Galaxy
SettingsOpeningPanel = Панель, показываемая при открытии лаунчера
SettingsOpeningPanelChangelog = История изменений
SettingsOpeningPanelStatus = Результаты проверки
SettingsOpeningPanelLinks = Полезные ссылки
SettingsOpeningPanelMods = Список модов
SettingsCloseOnLaunch = Закрывать лаунчер при запуске игры
SettingsCreateShortcut = Разместить ярлык на рабочем столе
SettingsOfflineMode = Запускать в оффлайн-режиме
SettingsOfflineModeTooltip = Запускать ли лаунчер сразу в оффлайн-режиме.[n]Не отражает состояние лаунчера, если он запущен в оффлайн-режиме из-за технических неполадок.
SettingsMakeBackup = Сделать резервную копию
SettingsMakeBackupInfo = Резервная копия всех файлов игры, с которыми работает лаунчер, будет создана в папке {0}[n]Продолжить?
SettingsMakeBackupDone = Резервная копия файлов успешно создана в {0}
OfflineModeSet = Оффлайн-режим включён. Перезагрузить лаунчер, чтобы изменения вступили в силу?
OnlineModeSet = Оффлайн-режим выключен. Перезагрузить лаунчер, чтобы изменения вступили в силу?
GamePathSelectionTitle = Укажите папку с игрой
EnterThePath = Укажите путь к папке, в которую установлена игра
NoExeInPath = В указанной папке отсутствует исполняемый файл игры!
OldGameVersion = Ваша версия игры ({0}) не поддерживается!
GogGalaxyDetected = Мы заметили, что у вас установлен GOG Galaxy. Должны ли мы запускать игру через него?
UpdatingLoncher = Обновляем лаунчер Battle Brothers RU...
UpdDownloading = Обновляем лаунчер - Скачиваем {0} ...
PreparingChangelog = Читаем новости...
PreparingToLaunch = Проверяем файлы и запускаем лаунчер...
CannotGetLocaleFile = Не удаётся загрузить файлы локализации
CannotGetImages = Не удаётся загрузить картинки
CannotSetBackground = Не удаётся установить изображение в качестве фона
CannotGetFonts = Не удаётся загрузить шрифты
CannotCheckFiles = Не удаётся проверить файлы
MultipleFileBlocksForSingleGameVersion = В настройках повторяется блок файлов для версии "{0}"
CannotParseConfig = Не удаётся прочитать файл конфигурации
CannotLoadIcon = Не удаётся загрузить иконку
CannotParseSettings = Не удаётся прочитать настройки лаунчера
CannotUpdateLoncher = Не удаётся обновить лаунчер
LoncherOutOfDate1 = Лаунчер устарел.[n][n]И, судя по всему, админ не положил ссылку на новую версию,[n]поэтому мы просто не дадим запустить лаунчер.
LoncherOutOfDate2 = Обновлённый лаунчер имеет проверочную сумму своего предка и не соответствует требуемой проверочной сумме.[n][n]Админ либо не обновил проверочную сумму, либо не обновил ссылку на лаунчер.[n]Запускаться мы при таком раскладе не будем из соображений безопасности.
LoncherOutOfDate3 = Версии лаунчера указывают друг на друга в качестве более новой.[n]Прекращаем работу во избежание зацикливания обновления.
WebClientError = Не удаётся получить настройки для лаунчера.[n]Вероятно, у вас нет подключения к интернету.
WebClientErrorOffline = Не удаётся получить настройки для лаунчера.[n]Вероятно, у вас нет подключения к интернету.[n][n]Повторить попытку подключения, или попробовать запустить лаунчер в оффлайн-режиме?
FileCheckNoFilePath = Не указан путь или имя файла.[n]Свяжитесь с человеком, настраивавшим лаунчер (там, откуда скачали лаунчер)." }
FileCheckInvalidFilePath = Указан некорректный или абсолютный путь к файлу.[n]Абсолютные пути запрещены из соображений безопасности.[n]Свяжитесь с человеком, настраивавшим лаунчер (там, откуда скачали лаунчер).[n][n]Проблемный путь:[n]{0}
